1111111111
10000000011
100000C00111
100000000111
100E0000011
1111111111
