111111
1000E1
10CC01
1P0001
111111