1111111111111
10010000000C1
1P00010110001
100010E100001
1111111111111