1111111111111
100C0000W00C1
1P0000E100001
1CCCCCC1CCCC1
1111111111111