1111111111111111111
1C00C000C00100010E1
1001011111010100001
10010010C1010101001
1001C01001000101001
1P000011000100010C1
1111111111111111111